NO ./texture_labirinthe/wall.xpm
SO ./texture_labirinthe/wall.xpm
WE ./texture_labirinthe/wall.xpm
EA ./texture_labirinthe/wall.xpm
F ./texture_labirinthe/grass.xpm
C ./texture_labirinthe/sky.xpm


111111111111111111111111111
100000000000000000000000001
101110111011101110111011101
100010000010000010000010001
100010000010000010000010001
101110111011101110111011101
101000000000000000000000101
100011101111111111011100001
100010001000100010001000001
100011101000100010111100001
10100000W000100000000000101
100011111111111111111111001
111111111111111111111111111