NO ./textures4/bleuwall.xpm
SO ./textures4/bleuwall.xpm
WE ./textures4/bleuwall.xpm
EA ./textures4/bleuwall.xpm
F ./textures4/purplefloor.xpm
C ./textures4/skydungeon.xpm

111111111111111111111111111
100000000000000000000000001
101110111011101110111011101
100010000010000010000010001
1000100000100000100000100011
10100000110000000000000000101
100011101111111111011100001111111111
100010001000100010001000001
100011101000100010111100001
10100000W000100000000000101
100011111111111111111111001
111111111111111111111111111