c0123 


lol
piou


111111
10111111
101  101
11111111
1000011
1111111
