NO ./texture_labirinthe/cleanwall.xpm
SO ./texture_labirinthe/cleanwall.xpm
WE ./texture_labirinthe/cleanwall.xpm
EA ./texture_labirinthe/cleanwall.xpm
F 220,200,0
C 225,30,0

1111111
1N00001
1111111