111111
100101
101001
1100K1
111111