NO ./textures2/wall.xpm
SO ./textures2/wall.xpm
WE ./textures2/wall.xpm
EA ./textures2/wall.xpm
F ./textures2/grass.xpm
C ./textures2/sky.xpm

111111
1N0001
100  1
100001
111111