NO ./textures_B/wall.xpm
SO ./textures_B/wall.xpm
WE ./textures_B/wall.xpm
EA ./textures_B/wall.xpm
F ./textures_B/grass.xpm
C ./textures_B/sky.xpm

111111
1N0001
1S0001
100001
111111